ausrichten: alinear, orientar		poniendo kebab en fila en la mesa, AUStinpower
aussehen: lucir, parecer		AUStin luciendo un traje de lentejuelas entrando, la tia mirandole pero como a traves de el sin impresionarse
äußern: expresar, manifestar		AUS gritando y con pancartas, y le da un ERNia
auswählen: seleccionar, elegir		AUS eligiendo una de las tres puertas le toca una whale
auswirken: afectar, influir		AUS haciendo temblar el baño y dentro el capitan Kirk que no puede mear
autorisieren: autorizar		Mirando el carnet para entrar a la clase y le authoriza un polizei.
basieren: basar		Sherlok holmes basando/fundando un obelisto sobre una huella
bauen: construir		
beachten: observar, tener en cuenta		Mirando con una lupa las migas de los sillones, Berry y encuentra 8 y luego 10
bearbeiten: editar, procesar		-
bedenken: considerar, reflexionar		Berry pensando en la cocina, mesandose la barbilla.
bedeuten: significar, implicar		-
beeinflussen: influir		berry hablandole al oido y la tia se cruza y la atropellan, como el diablo en pactar con el diablo, y se toma un infusion con una bolsita.
beeinträchtigen: afectar, perjudicar		berry se pone un traje y  hitler le da una copa y se pone pedo enseguida
beenden: terminar, finalizar		
befassen: ocuparse, tratar		berry cosiendo, le hablan y no se entera. Hasta que levanta la cabeza y pregunta: what's the FUSS?
befinden: encontrarse, estar		
beginnen: empezar, iniciar		
begrüßen: dar la bienvenida, saludar		
behalten: conservar, mantener		berry metiendo dinero en una lata de conservas, mientras entra al japones y se para de renpente delante de un camarero con muuuchas bebidas en la mano
behandeln: tratar, abordar		be tratando a un enfermo en la mesa, y le coge la mano
behaupten: afirmar, sostener		be en un juicio sosteniendo que es inocente. Y la coge el abogado y la aupa com el dirty dancing
beibehalten: mantener, conservar		
beinhalten: incluir		be añadiendo palillos en la comida para llevar, y cuando los mete IN todo se para como en matrix
beitragen: contribuir		be metiendo dinero en la ATM, y bebiendo un trago de agua despues.
bekämpfen: combatir, luchar contra		berry luchando en tiendas de KAMPaña con fan
bekommen: recibir, obtener		
bemühen: esforzarse, dedicarse		berry esforzandose en llevar un barril de birra a la hamburgeseria, y cuando terrmia de le sale moho y 
benötigen: necesitar, requerir		berry pidiendo un abre latas y como no se lo dan se poine naughty
benutzen: utilizar, usar		
beobachten: observar		berry enfrente de bach (ed harris) mirandose de abajo a arriba
berechnen: calcular		
bereitstellen: proporcionar, suministrar		berry tandole una caja de suministros, que esat lenna de ratas con estrellas
berichten: informar, reportar		be haciendo un reportaje, poniendole con el microfono en mano y tirando monedas de oro por atras, han ganado la loto(richten)
berücksichtigen: tener en cuenta, considerar		be teniendo en cuenta que tiene que pagar la renta y no compra el pan, le tira rocas, 60 y unos trajes de general
beruhen: basarse, fundarse en		be echando cimientos y al terminar se queda tranquila(ruhen)
beschäftigen: emplear, ocupar, mantener ocupado		be trabajando de farmaceutica, cogiendo el palo de bailarina
beschleunigen: acelerar		be acelerando el tren, manda callar y que se unan junten. Le hacen caso.
beschränken: limitar, restringir		be limitando el paso a los propios inquilino, sorry aforo limitado, y estos se hacen pequeños y entran igual, y dialgogan con KEN (ryan golish)
besitzen: poseer, tener		be de pobre cogiendo todas sus pertenencias, y se sienta
bestätigen: confirmar, corroborar		be dice que si le ha visto fuera, y le hacen la steticien
bestehen: consistir, existir, aprobar (un examen)		be ve un alien y siiii existen, y se queda con la power stand.
bestimmen: determinar, especificar		be especifica que el tomate es de tal variedad escribiendo el el titulillo, y sale humo del tomate
besuchen: visitar		be visitando un amigo, le deje pasar, atraves del frigorifico. y se besuquean
betonen: enfatizar, resaltar		be poniendo los quesos con leds y cantando en diverssos tonos
betrachten: considerar, contemplar, observar		be mirando que yogurt comprar, y se pone un traje mientras
betreffen: afectar, concernir		be aftectada no queda guacamole, y se juntan de repente los aguacates y cebollas para hacerse uno
betreiben: llevar a cabo, practicar, operar		be llevando al final un pez, y aparece uno de una tribu y le dice que lo baje