beweisen - demostrar		Berry demostrando el teorema de pitagoras, tomandose una bud WEISEr 
bewerten - valorar, evaluar		Berry acariciando un abrigo de Bison  y mirandolo, tira caramelos WERT
beziehen - referirse a, relacionarse con		berry se relaciona, se toquetea  con cien y señala a cada uno a otro diciendoles ese es mi novio
breiten - extender, desplegar		BradPit extendiendo un mantel para y se tira encima, y sale brillon
darstellen - representar		Unas marionetas representando politicos peleandose, uno repartiendo DAndo STELLas a los niños
deaktivieren - desactivar		Dean Norris desactivando una bomba
decken - cubrir		En un coche cubriendose para dormir con una manta y black and decker encima
definieren - definir		Poniendo Politi = crap en la pared
dienen - servir		Diana pasando canapes en la pelu
diskutieren - discutir		niños discutierndo por la pelota
doppeln - duplicar		El camarero se le cae una birra y al que le moja se convierte en su dopleganger
drehen - girar, rotar		Girando en el escaparate, un rehen atado con una D haciendole sonreir
dritteln - dividir en tres partes iguales		dividiendo en tres un pastel y poniendo un logaritmo en base n
durchführen - llevar a cabo, realizar		subiendo hasta el cabo, Matt deamon, y le atraviesa el führer cuando llega justo al final
durchmessen - medir, calcular		
dürfen - poder, tener permiso		LLamma a la puerta y cuando le dejan entrar se pone a surfear en un D
echoen - hacer eco, resonar		haciendo echo en la parte del ascensor
einen - uno (en función de artículo indeterminado)		
einfügen - insertar		insertando UNA tarjeta enorme, y sale un higo que estalla de puro maduro
eingeben - introducir, ingresar		Introduciendo un 1 en el baño, llega el siguiente y se lo da para que siga
eingehen - entrar, aceptar		Entra en la nevera y ve un UNO gigante andando
einigen - llegar a un acuerdo, conciliar		Dos unos dandose la mano y abrazandose mientras hitler les junta
einrichten - configurar, establecer		UN uno gigante, doblado de dolor, le configuran tocando una pass y se pone recto
einschliessen - incluir, encerrar		Un uno gigante, se tira a una bolsa de papel y dice SHHHH y se encierra 
einsetzen - utilizar, emplear		Un uno gigante utiliza un destornillador para cambiar de canal y cuando lo consige se sienta
einstellen - ajustar, configurar		un uno gigante ajustando los pomos del armario y configurando su situacion y cuando termina aparecen strellas
empfangen - recibir		Un empleado con traje de mercadona lleno de fango recibe un regalo
empfehlen - recomendar		Un empleadocon traje del mercadona le recomiendan unos libros, se los señalan y el tiembla de emocion
enden - terminar, finalizar		
entfernen - quitar, retirar		Un ENT se quita de la cama cuando le cae un ladrillo pero se enferm
enthalten - contener		UN ENT se contiene las ganas de llorar al ver eso y para todo como matrix
entsprechen - corresponder, equivaler		Un ENT le dan una bofetada y el la devulve y luego se ponen a hablar tranquilamente