erwarten: to expect, to anticipate		er waiting for the bulardo to go up, y se tira al suelo cuando le disparan
erweitern: to expand, to broaden		er expandiandiendose ante el grupo y le dicen anda VAI y toma la TERN
erzählen: to tell, to narrate		er contando un cuando a los ninios
erzeugen: to produce, to generate		er produciendo energia con una bobina, y aparece ZEUs y Hitler encime
erzielen: to achieve, to attain		er archivando papeles y le hacen la Z en la espalda y dice si si y  se da la vuelta y esta HELEN mirren ( en el espejo)
fasern: to fiber, to become fibrous		T1000 becoming fibers, cuando aparece un ovni, encuentros en la tercera fase
		
festlegen: to define, to determine		definiendo una escultura termina y se monta una fiestar y le ponen un pierna de caberetera encima
feststellen: to determine, to ascertain		Colombo determinando el asesino, se monta una fiesta y le salen estrellas fuegos artificiales
finden: to find, to discover		
folgen: to follow, to obey		following la gente la cumba? Nil olgerson being F
fordern: to demand, to require		harrison For Dando la ostia y la tia le señala y le demanda ante un poli
fördern: to promote, to support		harrison Ford con cara de E , clavada en el craneo promoviendo con una camiseta a los viejitos para que viajes man
formen: to shape, to form		la televesion tomando diferentes formas
fortsetzen: to continue, to proceed		siguendo la niña una bread crumbs y llega al fuerte de arena y se sienta y lo jod
freien: to court, to woo		llorando desconsoladamente, mientras frie
friedend: peace		sacando la bandera blanca en las sillas y saca el huevo de la sarten. END of FRIEN
fügen: to add, to join		pagandole x y el dice mas y el añade un fig
garantieren: to guarantee, to ensure		pidiendo garantias de que el cacheo no va a estropear sus testiculos 
gebieten: to command, to order		ordenando to meterse dentro de la maquina, cogen a uno vestido de hitler que se niega  y le beaten antes de meterlo 
gefallen: to please		haciendo un masaje hitler y se cae
gehören: to belong		hitler cogiendo el tren como que le pertenece y escuchando con las orejas 
gelangen: to reach, to get to		hitler haciendo sus brazos mas largos para alcanzar el la punta del tren
geleiten: to escort, to accompany		hitler escort a uno al baño y le dan una botella de leche, se la toma manchandose
gelten: to apply, to be valid		hitler aplicando cream a un ticket y poniendole la estampa, el viajero se vuelve ELTER (tha's me)
genießen: to enjoy		
geraten: to end up, to turn out		hitler viendo el final de la historia, como at the end ella una rata se lo come
geschehen: to happen, to occur		hitcler tira un moneda al aire y se pagandose con un checheno (con gorro checheno y barbas largas)
gestalten: to design, to shape		
gestatten: to allow, to permit		el general permitiendo salir a la chica al baño y pone una frase en la barra
gewähren: to grant, to bestow		hitler regalando a la basura (hay un duende) unas gafas de culo de botella para que VEREN el y su familia
gewährleisten: to guarantee, to ensure		hitler poniendo un sello de garantia al laptop (3 years) y le dice VERmeer chica gets the LAST lapto 