grenzen: to border, to delimit		puting a line on the sand y llegan cuervos
gründen - fundar		grindando en las escaleras mecanicas y se funda un emperio (edificios creciendo)
haken - enganchar		se engancha al atenderme en el lounge y me pongo a hackearle el sistemo
halten - sostener		sosteniendo el mundo, y le dicen no te muevas
handeln - actuar		actuando en la mesa y al terminar les da la mano a cada uno
hängen - colgar		colgandose para coger platos
herausfinden - descubrir		la descubre SS debajo de la casa de pin y pon
herschieben - empujar hacia		SS empujando y el dice SHE ben
herstellen - fabricar		
herunterladen - descargar		SS descargando pales los unta y los ladea
hervorragen - sobresalir		SS le sobre sale algo del pantaca, y se la forra
hervorwagen - aventurarse		SS con el gorro de indi y el latigo, y se pone delante de un WAGEN
holen - traer		trayendo un contenedor al bus y hace un HOLE y no puede
identifizieren - identificar		enseñandole el ID al arbitro
importieren - importar		
informieren - informar		dando las noticias entre las banderas
installieren - instalar		instanlando el gas en la casa blanca
investieren - invertir		vistiendo con dinero en el museo
jungen - rejuvenecer		rejuveneciendo el guardia como Benjamin Button, se convierte en niño
kämpfen - luchar		poniendo un camping en el agua y luchando con las perlas
klicken - hacer clic		haciendo click con una camare y la gente tapandose los oidos
knoten - atar		atando a la palmera y tocando musica (noten) con K
komplizieren - complicar		intenta abrir la puerta de la mezquita y cada vez aparecen mas puertas raras
konfigurieren - configurar		configurando la ballena desde el suelo y cae confeti
konzentrieren - concentrar		concentrando un zumo en la isla hasta que vuelve a ser pasta
kopieren - copiar		copiando el edificio triangular
korrigieren - corregir		
kriegen - obtener		obteniendo miel del edifiio apretandolo y se convierte en la guerra KRIEG
krümeln - desmoronar		El sheraton se desmorona y aparece Eduar Norton y Daniel Graig ( o aqui se ha escrito un crimen aNL)
kümmern - preocupar		Preocupandose del venado, acariciandole y dandole pienso, KIM basinger dandole mermelada
laden - cargar		Bin laden cargando al gorilla con electricidad
länden - aterrizar		
langen - bastar		haciendo el signo de basta descruzando los brazos y alargandolos hast tocar los dos edificios
lassen - dejar		Picachu dejando pasar a la gente por el edificio
lasten - cargar		El ultimo mohicano cargando a los Oryx con sacos
leiben - lamer		lamiendo la torre como una piruleta y hace pop (LAYs) BEN stealer
leiden - sufrir		Sufriendo siendo quemado en aceite y le dan una patata LAY
leisten - lograr		logra llegar a la parte de arriba de los tres y STAN comiendose un LAY
liefern - entregar		entregando el papel higienico una liebre a fernando en el baño
liegen - estar acostado		
linken - enlazar		enlazando las columnas y teletrasportandose 
listen - listar		listando todas las normas en el ring y los boxeadores escuchando con antecion
lodern - arder		en la parade seats ardiendo y les echan lodo
markieren - marcar		Arnold marcando a los camellos
meinen - significar		
meistern - dominar		dominando a los caballos y luego dando classes como un teacher, maestro a la escuela
melden - informar		comunicandole al halcon que puede volar y le da miel
mengen - mezclar		mezclando las capuchas y haciendose una manga
mitteilen - comunicar		le comunica a la gente que ya esta cerrad la terraza y les da un filete y les quita casi todo, dejandoles un MEAT parte
mögen - gustar		
mosern - quejarse		quejandose que no le compro nada, y se convierte en una morsa
müssen - tener que		
navigieren - navegar		navegando en la teteria
2. **nennen** - llamar		llamando a la gente desde la terraza, hey nenna
3. **normen** - normalizar		Norma (Marylin) dando normas de vestir y un burkaa las que no llevan burka 
4. **nuten** - estriar		saliendole estrias de esperar a que compren perfume - y las tias le dan nuts
7. **passen** - encajar/ajustar		encajando la maleta en la caja de seguridad y le dicen passen, passen
8. **passieren** - pasar/suceder		
9. **pflanzen** - plantar		plantando en la c2, se tira un cuesco y pone una lanza
10. **planen** - planificar		
11. **polen** - pulir		puliendo el mostrador y sale polen y estornuda
12. **positionieren** - posicionar		se pone a cuatro patas 
13. **posten** - publicar/postear		Pone un post y todos lo reciben en twitter en el Giraffe
14. **preisen** - elogiar		elogirando el sandwitch y la tia sube y sube el preissen
15. **proben** - probar		probando el sabor del marmol y sale un prove de la nasa
16. **profitieren** - beneficiarse		sacando dinero mientras tira basura, y se lleva unos profiteroles
17. **prüfen** - comprobar/examinar		comprobando que el descafeinado no tiene cafeina con un listmus, y luego en un puddding the prove is in the pudding
18. **punkten** - puntuar/marcar puntos		haciendo puntos en la mesa
19. **qualifizieren** - calificar/cualificar		sacandole un 10 como en el boxeo y le dan un diploman
20. **quellen** - brotar		brotando bajo los paneles y KU kux clan sancandoselo y es ELLE macferson