dort hin	over there	el jabon esta over there dice Stefanie para que friege -> se abre una puerta y aparece una hiena
daneben	beside	Al lado de la cafetera otra cafetera -> y por el medio el danubio azul
darüberhinweg	beyond	lasebuzzyear en el micro -> ordeñando una vaca mientras pasa un a hiena por el camino
darunterhinweg	underneath	debajo de los colchones lleno de bugs -> se acerca la camara y las bugs andand debajo de un camino y por encima la hiena
Selten (Rarely)		Una rana rara (principe) -> salteandola en una sarten
Kaum (Seldom)		Seldom el de BBT -> Explosion BB -> y se llena todo de KA y un UMMmmm buzz
Häufig (Frequently)		callendo una gota frecuentemente en la cama, -> hoy hoy, el capitan garfio -> comiendo higos
Gelegentlich (Occasionally)		poniendose el ocaso -> GErar the pardie poniendose la pierna al hombro como una bufanda
Einmal (Once)		El la ducha y cae una gota -> solo una vez -> y le cae fatal. 
Zweimal (Twice)		
Dreimal (Thrice)		
Täglich (Daily)		
Wöchentlich (Weekly)		
Monatlich (Monthly)		
Jährlich (Yearly)		
Jährlich (Annually)		
Zweiwöchentlich (Fortnightly)		
Vierteljährlich (Quarterly)		
Sofort (Instantly)		Abre el grifo y se llena instantaneamente todo el cuarto de baño de agua -> y aparece la masa (soo fuerte)
Unverzüglich (Immediately)		se mete superman en el armario y se cambia inmediatament -> y FER salta a caballo un uno y se pone en un zug (tren) y se raspa el culo.
Schließlich (Eventually)		una cuchara raspando una cuarda y eventualmente la corta => SCH lijando una flor de lis, se asusta cuando la cuerda se rompe
Ehemals (Formerly)		Aparece Mark, formerly CEO -> Casado con el demonio (MAL)
Kürzlich (Recently)		huele un croissant y esta recien hecho -> y se lo como KURz, russel
Aktuell (Presently)		dando un present en frente de las noticias -> y dicen luego corten, corten. Fue un ACTO
Regelmäßig (Regularly)		Poniendo una regla detras de otra haciendo un cuadrado (figura regular) --> y se pone a amasar luego
Gleichzeitig (Simultaneously)		se ponen a teclear a la vez los dos -> y se cruzan el reloj como en "parker luis nunca pierde" 
Neulich (Recently)		aparece el nuevo envase de leche con forma de vaca -> y a lijarla y sacar brillo
Endlich (Finally)		Llegan al final del camino, dejan las motos y las lijan
Zuerst (Initially)		Para empezar, initially, sube las rejas -> y ziZU esta mirandolo fijamente. 
Deshalb - Por lo tanto		has consumido esto por lo tanto -> le corta por la mitad
Darum - Por lo tanto		se come un durum
Daher - Por lo tanto		le da en la cabeza a her
Demzufolge - Por lo tanto		Le da un EM and em a ZU y este le sigue al salir
Mithin - Por lo tanto		Uno sentado con una hiena
Denn - Porque		Porque no hay croissants -> por que se estan haciendo. Denis olgerson
Aufgrunddessen - Debido a eso		por que se estan haciendo sube -> a comer a arriba
Daraufhin - En respuesta a eso		le da una colleja arriba la hiena - y esta le responde
Aus diesem Grund - Por esta razón		sale de debajo de la tierra de las mesas -> un radio. 
Somit - Así que		tengo que llegar pronto le dice-> asi que me voy -> sooo meat le dice a la vaca cuando intenta ir con el
Folglich - Por consiguiente		Multiplica con el siguiente, literal -> en forma de cruz los pone -> y sigue lijando como si nada
Im Folgenden - En consecuencia		caen unos dominos al final de la tienda
Infolgedessen - En consecuencia		comiendo debajo de unas faldas