boshaft	malicious, mean	Jim carrey con la mascara entrando en la cafeta y le meten en la bosh y le sale una afta
brav	well-behaved, good	un princesita comiendo con good maners unas patatas bravas que pican increible, pero ella no se inmuta.
charmant	charming	un encantador de serpientes encantando una manta
dankbar	grateful, thankful	le da un millon de gracias y una barra de acero
direkt	direct, straight	le da un directo
doof, dumm	stupid, dumb	dos tontos muy tontos y los DOs se caen OFf inconscientes. Se chocan
ehrgeizig	ambitious	El tio gilito vestido de her, haciendo el gay y dandodo tumbos
ehrlich	honest	Sharon dandole unos golpecitos en la cabeza a unos boyscouts - Y HER lichandose la manos luego, que asco
eifersüchtig	jealous	Celoso de ver a su chica darle un beso a otro en el count down, se cae la torre EIFEr sobre un viejo de 60 años
einfach	simple, plain, easy	
eingebildet	conceited, vain	caminando con las manos en los tirantes _> se choca on un uno y GEorge C le rompe un BILD en la cabeza
einmalig	unique	El goldfinch colgado de un uno con cara de MALIGno
ekelhaft	nasty, detestable	El de despicable -> akel tiene mucho peso heft
empfindlich	sensitive	con la piel de gallina, en cuanto pasa un airecillo -> se encuentra una lija en el empeine
eng	narrow, close	tiene que pasar entre dos bloques de cemento _> por ser engles
engagiert	dedicated, committed	con pico y pala _> ENGAGing y se queda ERTE (le despiden)
engstirnig	narrow-minded	le dejan la cabeza plana de un bofeton con las dos manos -> a un ENGlish y le da en el STiRNon
entscheidend	decisive	se decide a tirarse en monopatin
entspannend	laidback	relajado en una amaca
erfolgreich	successful	yess!! de rodillas resbalando por el asfalto -> ER y le sigue FOLG el REICH
ernst	serious	ernesto very serious
erstklassig	first-class, high-quality, topnotch	cristiano ronaldo en primera classe
faszinierend	fascinating	flipando con el fascista de musolini
faul	lazy	mas vago que la chaqueta de un guarda currando -> le pitan FAUL un arbiro
feig	cowardly	con el rabo entra las piernas mientras roba de la furgo -> canta FA FA y se le cae un IGo
fein	fine	
fest	solid, strong, firm	fuerte como de ladrillos, el hombre de piedra -> con gorrito de fiesta y matasuegrass
fett	fat	Nooorman comiendo FETTa