feigling	coward	huye por la puerta giratoria y se tira con FE a por un hIGo mientras le lanzan un sLING
fleißig	diligent, hard-working, industrious	Goenka meditando y matando una FLY BIG
fortgeschritten	advanced	un avalancha (avanza) ponen un fuerte y GE dicen SCHHH no gRITEN
frech	naughty, cheeky, sassy	frotandose contra la puerta un FREnCH (GERARD de Pardieu)
frei	free	
fremd	foreign, strange	un extrangero preguntando por la calle en chino -> y aparece FREdy mercury y le da un MDma
freundlich	friendly, kind	
froh	happy	uno saltando al bithday happy -> y se que congelado FROh
fröhlich	cheerful	otro abajo lleno de brindins, y empapado en cerveza -> FREDo (pero contento) y quitandose el liquido con lija
fromm	pious	circuncidandose antes de entrar, como buen judio pio -> y le sale FROMmage
gastfreundlich	hospitable	amablemente le deja entrar con un gorrito de enfermera a lo que es un hospital -> y el respira (GAST) sorprendido al reconocer que es su AMIGA de la infancia. Que se a LICHado la cara. Por eso no la reconocia
gebildet	educated, cultured	GEorge con traje de estudiante y gafa pasta mirando un BILD
geduldig	patient	esperando a que llueva con la mano levantada pacientement -> GE y dildo con forma de U en la mano
gefährlich	dangerous	jugando con una pistola -> GE y FER le escolda y lija
gefühlvoll	sensitive, emotional	GE sintiendo su cuerpo entero y se pone a llorar
geistreich	witty, brilliant	GE brillando con gafas de pasta y se convierte IST en uno del REICH que pasan justo por ahi
geizig	stingy, cheap	el tio gilito otra vez
gemein	low, rude, vulgar	Tyson pegando un golpe bajo, a GE y le dice el donuts es mine
gemeinsam	common, mutual	se junta GE y otro en el 4*4  pero aparece SAM y dice sorry it's mine
gemütlich	pleasant, cozy	tumbado en una amaca dentro de la kelo preciosa, llena de plantas -> GE y le tiran un trozo de MIT y se pone a lijarlo
gescheit	clever, bright	el doctor miguel brillando la cabeza enorme -> y GE se ciega y pisa un SCHEIbe. 
geschickt	skillful	CR regateando a GE mientras GE mira a unas CHICKS pasando
geschwätzig	talkative, chatty	BRuce hablando con tokiski -> y aparecen GE y SCH y dejan un charco WET en ZIG ZAG cuando se alejan despues de haber hablado con el mismisimo Bruce lee
gesellig	sociable, friendly	Brad hablando con la penia en una fiesta - GE mientras vendiendo higos. No muy contento.
gesund	healthy	
gierig	greedy	Patricia Arkett cogiendo todo el dinero del suelo, a brazadas -> y un GIRI riendose (con pantalon corto, calcetines y flipflps)