wischen (v) wipe		pasandole un paño al cristal, mientras los de la fila wishhh con las manos juntas, implorado
putzen (v) clean		limpiando los platos y poniendolos PUT secos en la cabeza de un tio haciendo zen. 
trocknen (v) dry		secando las escaleras mecanicas con un secador y pasa un TRUCK y la arrolla. Y luego rOOcks
staubsaugen (v) vacuum		con las aspiradora aspirando los jamones, Jaffa (S) apuñalandole y le hace mirar BE a SAUron 
fegen (v) sweep		barriendo a uno rezando y con los GENitales fuera
wegräumen (v) put away		colocando todo en su sitio en el arbol, y pintando un camino WEG....
wischen (v) mop		pasando el agua al oso, tocandole para que se convierta en oro y las manos en pray, juntas
herausbringen (v) take out		sacando la basura del garito y metiendao a ella HER AUS BRINGEN
		
blühen (v) bloom		poniendo chocolate en las macetas y la flores crecen cuando sopla BLOwEN
welken (v) wilt		las flores se marchitan con la birra, y se van andando
		
inspizieren (v) inspect		En la bola inpeccionando que funciona para las campanadas
beschlagnahmen (v) confiscate		confiscando los policias los abanicos, hechando BESCHAmeL vistiendose do gnomos.
verzollen (v) declare		Declarando que lleva vino, fernando se pone la mascara del Zorro y se mete en una ola
Steuern bezahlen pay taxes		Pagando las tazas, halle Berry con hernia dolor en la espalda contando las tazas
ausfüllen (v) fill out		rellenando un form para indicar que puede beber, y la casa AUS tirita, tiemba por ue siente pen
		
umrechnen (v) convert		convertiendo el carbon en turron, se queda pensativo quien lo ve UMM y  le ponenuna corona para que reine al mago que lo hizo
umrechnen (v) change		
umrechnen (v) change		
		
wechseln (v) convert		
wechseln (v) change		
		
rennen (v) run		se pone a correr cuando los leones se mueven
springen (v) jump		
schießen (v) kick		le da una patada a la mesa y le señala a ella, SHE IS
tanzen (v) dance		bailando en la puerta del hotel, Tarzan. 
angeln (v) fish		pescando en la puerta del teatro y baja un angel para ponerle un pescado
		
einchecken (v) sign in		firma un seguro andtes de subir al autobus, y le dan un checke
einchecken (v) check in		
auschecken (v) check out		sale del metro inundado pidiendo sus fichas de casino. 
		
klopfen (v) knock		tocando en la puerta
jubeln (v) cheer		en el parque gritando de jubilo
verlieren (v) lose		perdiendo a piedra, papel o tijera con cibeles, fernando y se pone a tocar la lira
gewinnen (v) win		viendo el gol de iniesta, hitler